333333333333333333333333333333333333333333333333333333333333
333333333333333333333333333333333333333333333333333333333333
335555555555555555555555555555555554444555555555555555555533
335555555555555555554444555555555554444555555555555555555533
335555555555555555554444555555555555555555555555555555555533
335555555555555555555555555555555555555555555555555555555533
335555555555555444455555555555511115555444455555555555555533
335555555555555444455555555555511115555444455555555555555533
335555555555533333333333333333333333333333333555555555555533
335555555555533333333333333333333333333333333555555555555533
335555555555533333333333333333333333333333333555555555555533
335555555544533333333333333133333333333333333555555555555533
335555555544533322222222222222222223333332313555555555555533
335555555544533323333333333133333323333332313555555555555533
335555555544533323333333333333333322222221313555555555555533
335555555555533323333333333333333323333333333555555555555533
335555555555533323333333333333333133333333333555555555555533
335555555555533323313333333331311133333333313555555555555533
335555555554433333333331133333333333333111113555555555555533
335555555554433323313333333331311133333333313555555555555533
335555555554433323333333333333333133333333333555555555555533
335555555554433323333333333333333323333333333555445555555533
335555544555533323333333333333333322222221313555445555555533
335555544555533323333333333133333323333332313555445555555533
335555544554433322222222222222222223333332313555445555555533
335555544554433333333333333133333333333333333555555555555533
335555544554433333333333333333333333333333333555555555555533
335555555554433333333333333333333333333333333555555555555533
335555555554444555544445554444444455444455555555555555555533
335555555554444555544445554444444455444455555555555555555533
335555555555555555555555555555555555555555555555555555555533
335555555555555555555555555555555555555555555555555555555533
335555555555555555555555555555555555555555555555555555555533
335555555555555555555555555555555555555555555555555555555533
335555555555555555555555555555555555555555555555555555555533
335555555555555555555555555555555555555555555555555555555533
335555555555555555555555555555555555555555555555555555555533
335555555555555555555555555555555555555555555555555555555533
333333333333333333333333333333333333333333333333333333333333
333333333333333333333333333333333333333333333333333333333333